Bad 	Schlecht	
Schlecht	Bad	
Antwort	answer	
immer noch 	still	
schlimmsten	worst	
gerade	just	
gemerkt	realize	
spiele	play	
mitgebracht	'with her'<br>	
beim	for	
sagt (pronounced: za-k-ht)	said	
fertig	finished	
treffen	meet	
gegen	against	
immer	always	
diskutiert	discussed	
aufmachen	open&nbsp;	
allein	alone	
einschlafen	fall asleep	
wieder	again	
recht	very / quite&nbsp;	
schaut	watches	
nur	only	
Fernsehen	TV	
Ich weiß es nicht.	I don't know	
wohne	live	
Meer	sea	
es gibt	there is	
sagen	say	
meistens	usually	
benutzen	use	
darf	allowed	
versuche (prns: ver-zu-khe)	try	
selbst (zel-btz)	self	
Zeit (sei-t)	time	
denke	think	
vielleicht (pro: fie-liecht)	perhaps	
Warum (wa-hum)	why	
Gestern	yesterday	
wenige (way-ni-ge)	few	
Wohnung	apartment	
entfernt (ent-fay-arnt)	away/removed	
schwierig (sch-wei-rich)	difficult	
unserer (un-ze-har)	our	
Ich weiß&nbsp;	I know	
Du hast Nein gesagt	you have said no	
Das heißt	this means	
wieder	again	
ich kann wieder gehen	i can go again	
Anhung	idea	
ich weiß nicht	i dont know	
Das versuch ich&nbsp;	i am trying	
&nbsp;einfach	easy	
Steht dir gut	Looks good on you	
schwarz	black	
gingen	went	
das ist wie...	that is like...	
Ahnung	feeling	
gefallen	please	
weißt	know / white<br>	
Ich habe nicht viel <i><b>verstanden</b></i>	"i did not <b style=""font-style: italic;"">understand </b>much&nbsp;"	
Er hat die Maske überall <b><i>getragen</i></b>	he <b>carried </b>the mask everywhere	
Büro	office	
Das ist Kunst	this is art	
Der Film war <b>ziemlich</b> <b>langweilig</b>	<b>quite boring</b><br><br>zeimlich -- (zeim - lisch)<br><br>langweilig&nbsp;(lang-weilisch)	
das war egal	that didn't matter	
Sie hat ihren Kopf auf meine Schulter <b>gelegt</b>.	placed	
Nach dem Film	after the film	
wie <b>lange</b> sie in Hamburg <b>bleibt?</b>	how long she stayed in Hamburg?	
Sie ist <b>noch</b> sehr jung	<b>still</b>	
„Irgendwas mit Geld“	something with money	
<b>bis</b> es ein Uhr morgens war	<b>until </b>it was one in the morning.	
<b>Sonst</b><br>verpasse ich meinen Bus morgen!	Otherwise, I'll miss my bus in the morning	
Sie <b>nahm</b> einen <b>Stift</b>	she <b>took </b>a <b>pen</b>	
<b>schrieb</b> etwas und gab mir den Zettel.	<b>wrote</b>&nbsp;something and gave me the note	
verschwunden (versh-wunden)	disappeared	
Dann küsste sie mich auf die Wange	Then kissed me on the cheek	
beantworten	Respond	
Er wird das <b>aufschreiben</b>.	He will <b>write</b>&nbsp;that down	
Ich werde dich <b>immer lieben</b>	I will <b>always</b>&nbsp;<b>love </b>you	
Weiß ich noch nicht.	I do not know yet	
wir bist du?	who are you?	
Was ist mich denen hier?	What about them here?	
Niemand liebt dich	Nobody loves you	
Wer war das?	Who was that?	
Ich hatte wirklich <b>keine Ahnung.</b>	I really had <b>no idea.</b>	
Ihnen auch	You too	
bin gleich<b> </b>wieder <b>da</b>	will be right <b>back</b>	
Ist das verrückt?	is that crazy?	
Daran hatte ich nicht <b>gedacht</b>	I had not <b>thought</b>&nbsp;of that	
Weißt	know	
jedenfalls	anyhow	
<b>Ist ja </b>nur mein freier Tag.	<b>It's </b>just my free day.	
Danke, dass du mich zur Arbeit fährst.	Thank you for driving me to work.	
Wollen wir noch mal?	<pre>Do we want to go again?<br></pre>	
Wir können nach Hause fahren.	We can go home.	
er klettert auf den Baum	he climbs on the tree	
klettern ist gefährlich	climbing is dangerous	
Ich <b>spüre</b> meine Füße nicht mehr.	I can't <b>feel </b>my feet anymore.	
ganz nass	all wet	
wir gehen zurück nach hause	we are going back home	
Schnell	Fast	
Königin	Queen	
glücklich	Happy	
Bitte lerne es zu fahren!	Please learn to drive!	
Ich <b>weine um die Zukunft</b>	I <b>cry for the future&nbsp;</b>	
Wir wollten auch gerade gehen.	We were about to go too.&nbsp;	
Wir wollten gesehen.	We wanted to see.	
Was&nbsp;<b>brauchst</b>&nbsp;du?&nbsp;	what do you <b>need</b>?	
erfahren	experience / find out	
vielleicht	perhaps	
Sie gehen geradeaus	You go straight on	
Das heißt, nur ein bisschen geradaus	that means, straight on for just a little	
Da gibt's gar keine Bäckerei&nbsp;	There isn't a bakery	
Viel Erfolg!	Good luck!	
Ich habe mich verlaufen	I have got lost	
Die Richtung	The direction	
In welche Richtung muss ich gehen?	In which direction do I need to go?	
ich suchen <b>nach</b> ein Bäckerei.	i am looking <b>for </b>a bakery	
die Seite (pronounced: zeite)	the side	
Man kann sagen.. (pronounced: zagen)	you can say	
Sie finden die Adresse auf der linken Seite.	You'll find the address on the left-hand side	
ein paar Mal	a few times	
Er ist stolz auf mich.	He is very proud of me	
verlangen	demand	
was ist los mit dir?	what's wrong with you?	
dreht sich um	turns around	
mitten im wald	in the middle of the woods	
ganz oben	at the top	
steht sie unten	she stands below	
und dan <b>ruft</b>	and then <b>calls</b>	
lass dein <b>haar herunter</b>	let your<b> hair down</b>	
Er hört eine <b>stimme</b> singen	<div>He hears a <b>voice</b> sing</div>	
der Prinz kann es nicht <b>glauben</b>	the prince can not believe it	
Ohne Rapunzel wil er nich liben	"<div><div><div><div><div><div><div><div>He doesn't want to live without Rapunzel</div><div></div><div><div><div><div><img src=""paste-c047e14da36fd16790765c22ad62a45dac8fb060.png""></div></div></div></div></div></div></div></div></div></div></div>"	
überlebt	survived	
<b>die Geschichte</b>	the story	
oben	above	
stadt	city	
jetzt erzähle Ich euch diese Sage.	now I am telling you this story/legend	
Ich kann <b>euch</b> helfen mit den Ratten	I can help <b>you</b> with the rats	
sterben	die	
der Mann <b>bekommt</b> kein Geld	the man doesn't <b>recieve</b> any money	
beliebteste	most popular	
Es gibt 83 Million menschen in Deutschland	There are ...	
Deutschland hat <b>auch </b>(au-kh)&nbsp;16 staaten.	Germany <b>also</b> has 16 states.	
Das sind unserer staaten.	These are our states	
<b>Das sind</b> städte.	<b>these are</b> cities	
verschiedene (pronounced: fer--)	different	
Was&nbsp;hast&nbsp;du&nbsp;dann&nbsp;getan?	What did you do then?	
was&nbsp;denkst&nbsp;du&nbsp;denn?	what do you think?	
<b>bekomme</b> ich nur Werbung	i only <b>get</b>&nbsp;advertisements	
<b>Viele von ihnen</b> sind jung.	<b>Many of them </b>are young.	
Gustavo hat mir <b>gezeigt</b>.	Gustavo <b>showed</b>&nbsp;me	
dann <b>legt</b> man ein paar <b>Stücke Holz</b>	then you&nbsp;<b>put </b>a few <b>pieces of wood</b>	
Wenn das <b>Holz knistert</b>	When the <b>wood crackles.</b>	
legt man die Kohle<br><b>hinein</b>	you put the coal <b>into it</b>	
Nach einer <b>Weile</b> wird es schön warm.	After a <b>while</b>&nbsp; it gets nice and warm	
Wir haben eine Tonne Kohle <b>bestellt</b>	We <b>ordered</b> a ton of coal	
Wir wohnen im <b>vierten Stock</b>	We live in the <b>fourth floor</b>	
Der Sack ist sehr schwer.	The sack is very heavy	
Wir <b>tragen</b> ihn...	We carry it...	
Unsere Nachbarn <b>beschweren</b> sich	Our neighbours are <b>complaining</b>	
Aber was sollen wir tun?	But what should we do?	
<b>tragen</b> ihn<br>in den vierten Stock.	<b>carry</b> him to the 4th floor	
<b>Kasten</b> unter dem <b>Fenster</b>	Box under the window	
ziemlich	quite	
gefährlich	dangerous	
verlieben	falling in love	
Versprechen /&nbsp;Versprecht	promise	
Wer hätts gedacht?	Who would have thought?	
zeit <b>verbringen</b>	<b>spend</b> time	
versprechen gemacht	<div>promise made</div>	